WWWWWWWWWWWWWWWWWWWWWWWWWWWWWWWW
WWWWWWWWWWWWWWWWWWWWWWWWWWWWWWWW
WWLLLLLLLLLLLLLLLLLLLLLLLLLLLLWW
WWLLLLLLLLLLLLLLLLLLLLLLLLLLLLWW
WWLLLLLLLLLLLLLLLLLLLLLLLLLLLLWW
WWLLLLLLLLLLLLLLLLLLLLLLLLLLLLWW
WWLLLLLLLLLLLLLLLLLLLLLLLLLLLLWW
WWLLLLLLLLLLLLLLLLLLLLLLLLLLLLWW
WWLLLLLLLLLLLLLLLLLLLLLLLLLLLLWW
WWLLLLLLLLLLLLLLLLLLLLLLLLLLLLWW
WWLLLLLLLLLLLLLLLLLLLLLLLLLLLLWW
WWLLLLLLLLLLLLLLLLLLLLLLLLLLLLWW
WWLLLLLLLLLLLLLLLLLLLLLLLLLLLLWW
WWLLLLLLLLLLLLLLLLLLLLLLLLLLLLWW
WWLLLLLLLLLLLLLLLLLLLLLLLLLLLLWW
WWLLLLLLLLLLLLLLLLLLLLLLLLLLLLWW
WWLLLLLLLLLLLLLLLLLLLLLLLLLLLLWW
WWLLLLLLLLLLLLLLLLLLLLLLLLLLLLWW
WWLLLLLLLLLLLLLLLLLLLLLLLLLLLLWW
WWLLLLLLLLLLLLLLLLLLLLLLLLLLLLWW
WWLLLLLLLLLLLLLLLLLLLLLLLLLLLLWW
WWLLLLLLLLLLLLLLLLLLLLLLLLLLLLWW
WWLLLLLLLLLLLLLLLLLLLLLLLLLLLLWW
WWLLLLLLLLLLLLLLLLLLLLLLLLLLLLWW
WWLLLLLLLLLLLLLLLLLLLLLLLLLLLLWW
WWLLLLLLLLLLLLLLLLLLLLLLLLLLLLWW
WWLLLLLLLLLLLLLLLLLLLLLLLLLLLLWW
WWLLLLLLLLLLLLLLLLLLLLLLLLLLLLWW
WWLLLLLLLLLLLLLLLLLLLLLLLLLLLLWW
WWLLLLLLLLLLLLLLLLLLLLLLLLLLLLWW
WWWWWWWWWWWWWWWWWWWWWWWWWWWWWWWW
WWWWWWWWWWWWWWWWWWWWWWWWWWWWWWWW