WWWWWWWWWWWWWWWWWWWWWWWWWWWWWWWW
WWWWWWWWWWWWWWWWWWWWWWWWWWWWWWWW
WWLLLLLLLLLLLLLLLLLLLLLLLLLLLLWW
WWLLLLLLLLLLLLLLLLLLLLLLLLLLLLWW
WWLLLLLLLLLLLLLLLLLLLLLLLLLLLLWW
WWLLLLLLLLLLLLLLLLLLLLLLLLLLLLWW
WWLLLLLWWWWWWWWWWWWWWWWWWLLLLLWW
WWLLLLLLLLLLLLLLLLLLLLLLLLLLLLWW
WWLLLLLLLLLLLLLLLLLLLLLLLLLLLLWW
WWLLLLLLLLLLLLLLLLLLLLLLLLLLLLWW
WWLLLLLLLLLLLLLLLLLLLLLLLLLLLLWW
WWLLLLLLLLLLLLLLLLLLLLLLLLLLLLWW
WWLLLLLLLLLLLLLLLLLLLLLLLLLLLLWW
WWLLLLLLLLLLLLLLLLLLLLLLLLLLLLWW
WWLLLLLLLLLLLLLLLLLLLLLLLLLLLLWW
WWLLLLLLLLLLLLLLLLLLLLLLLLLLLLWW
WWLLLLLLLLLLLLLLLLLLLLLLLLLLLLWW
WWLLLLLLLLLLLLLLLLLLLLLLLLLLLLWW
WWLLLLLLLLLLLLLLLLLLLLLLLLLLLLWW
WWLLLLLLLLLLLLLLLLLLLLLLLLLLLLWW
WWLLLLLLLLLLLLLLLLLLLLLLLLLLLLWW
WWLLLLLLLLLLLLLLLLLLLLLLLLLLLLWW
WWLLLLLLLLLLLLLLLLLLLLLLLLLLLLWW
WWLLLLLLLLLLLLLLLLLLLLLLLLLLLLWW
WWLLLLLLLLLLLLLLLLLLLLLLLLLLLLWW
WWLLLLLWWWWWWWWWWWWWWWWWWLLLLLWW
WWLLLLLLLLLLLLLLLLLLLLLLLLLLLLWW
WWLLLLLLLLLLLLLLLLLLLLLLLLLLLLWW
WWLLLLLLLLLLLLLLLLLLLLLLLLLLLLWW
WWLLLLLLLLLLLLLLLLLLLLLLLLLLLLWW
WWWWWWWWWWWWWWWWWWWWWWWWWWWWWWWW
WWWWWWWWWWWWWWWWWWWWWWWWWWWWWWWW